BBBBBBBBBBBBBBBBB
BRRRRRRRRRRRRRRRB
BRDYRDDDDDNDRDDRB
BRDNDDDDRRDDDDDRB
BRDDDRDDDRDDRDDRB
BZDDDRDDDRDDDDDDX
BRRDDRRRRRDDDDDRB
BRDDDDDRDDDDRDDRB
BRDDRDYDNDDDDNDRB
BRRRRRRRRRRRRRRRB
BBBBBBBBBBBBBBBBB