RRRRRRRRRRRRRRR
RDDRDDDDDNDRDDR
RDNDDDDRRDDDDDR
RDDDRDDDRDDRDDR
ZDDDRDDDRDDDDDX
RRDDRRRRRDDDDDR
RDDDDDRDDDDRDDR
RDDRDDDNDDDDNDR
RRRRRRRRRRRRRRR