RRRRRRRRRRRRRRR
RDDRDDDDDDDRDDR
RDDDDDDRRDDDDDR
RDDDRDDDRDDRDDR
RDDDRDDDRDDDDDR
RRDDRRRRRDDDDDR
RDDDDDRDDDDRDDR
RDDRDDDDDDDDDDR
RRRRRRRRRRRRRRR