BBBBBBBBBBBBBBBBB
BRRRRRRRRRRRRRRRB
BRDDRDDDDDNDRDDRB
BRDNDDDDRRDDDDDRB
BRDDDRDDDRDDRDDRB
BZDDDRDDDRDDDDDDX
BRRDDRRRRRDDDDDRB
BRDDDDDRDDDDRDDRB
BRDDRDDDNDDDDNDRB
BRRRRRRRRRRRRRRRB
BBBBBBBBBBBBBBBBB