RRRRRRRRRRRRRRR
RDDRDDDDDSDRDDR
RDSDDDDRRDDDDDR
RDDDRDDDRDDRDDR
RDDDRD1DRDDDDDR
RRDDRRRRRDDDDDR
RDDDDDRDDDDRDDR
RDDRDDDSDDDDSDR
RRRRRRRRRRRRRRR