RRRRRRRRRRRRRRR
RDDDDDDDDDDDDDR
RDDDDDDDRDDDDDR
RDDDRDDDRDDDDDR
RDDDRDDDRDDDDDR
RDDDRRRRRDDDDDR
RDDDDDDDDDDDDDR
RDDDDDDDDDDDDDR
RRRRRRRRRRRRRRR