RRRRRRRRRRRRRRR
RDDRDDDDDSDRDDR
RDSDDDDRRDDDDDR
RDDDRDDDRDDRDDR
RDDDRDDDRDDDDDR
RRDDRRRRRDDDDDR
RDDDDDRDDDDRDDR
RDDRDDDSDDDDSDR
RRRRRRRRRRRRRRR