RRRRRRRRRRRRRRR
RDDRRRRRRRRRDDR
RDDDRRRRRRRDDDR
RDDDDRRRRRDDDDR
RDDD1DRRRDDDDDR
RSDDDDDRDDDDDSR
RDDDDDDDDDDDDDR
RSDDDDDDDDDDDSR
RRRRRRRRRRRRRRR