BBBBBBBBBBBBBBBBB
BRRRRRRRRRRRRRRRB
BRDDRRRRRRRRRDDRB
BRDDDRRRRRRRDDDRB
BRDDDDRRRRRDDDDRB
BZDDDDDRRRDDDDDDX
BRDDDNDDRDDDDDNRB
BRDDDDDDDDDDDDDRB
BREDDDDDDDDDDDERB
BRRRRRRRRRRRRRRRB
BBBBBBBBBBBBBBBBB