RRRRRRRRRRRRRRR
RDDRRRRRRRRRDDR
RDDDRRRRRRRDDDR
RDDDDRRRRRDDDDR
ZDDDDDRRRDDDDDX
RNDDDDDRDDDDDNR
RDDDDDDDDDDDDDR
REDDDDDDDDDDDER
RRRRRRRRRRRRRRR