RRRRRRRRRRRRRRR
RRRNDDDDDDDNRRR
RRRDDDDDDDDDRRR
RDDDDRRRRDDDDDR
ZDDDDRRRRDDDDDX
RDDDDRRRRDDDDDR
RRRDDDDDDDDDRRR
RRREDDDDDDDERRR
RRRRRRRRRRRRRRR