RRRRRRRRRRRRRRR
RRRSDDDDDDDSRRR
RRRDDDDDDDDDRRR
RDDDDRRRRDDDDDR
ZDDDDRRRRDDDDDX
RDDDDRRRRDDDDDR
RRRDDDDDDDDDRRR
RRRSDDDDDDDSRRR
RRRRRRRRRRRRRRR