BBBBBBBBBBBBBBBBB
BRRRRRRRRRRRRRRRB
BRRRNDDDDDDDNRRRB
BRRRDDDDDDDDDRRRB
BRDDDDRRRRDDDDDRB
BZDDDDRRRRDDDDDDX
BRDDDDRRRRDDDDDRB
BRRRDDDDDDDDDRRRB
BRRREDDDDDDDERRRB
BRRRRRRRRRRRRRRRB
BBBBBBBBBBBBBBBBB