BBBBBBBBBBBBBBBBB
BRRRRRRRRRRRRRRRB
BRRRNDDDDDDDNRRRB
BRRRDYDDDDDDDRRRB
BRDDDDRRRRDDDDDRB
BZDDDDRRRRDDDDDDX
BRDDDDRRRRDDDDDRB
BRRRDDDDDDDDYRRRB
BRRREDDDDDDDERRRB
BRRRRRRRRRRRRRRRB
BBBBBBBBBBBBBBBBB