RRRRRRRRRRRRRRR
RRRSDDD1DDDSRRR
RRRDDDDDDDDDRRR
RDDDDRRRRDDDDDR
RDDDDRRRRDDDDDR
RDDDDRRRRDDDDDR
RRRDDDDDDDDDRRR
RRRSDDDDDDDSRRR
RRRRRRRRRRRRRRR