BBBBBBBBBBBBBBBBB
BRRRRRRRRRRRRRRRB
BRDYRRRRRRRRRYDRB
BRDDDRRRRRRRDDDRB
BRDDDDRRRRRDDDDRB
BZDDDDDRRRDDYDDDX
BRDDDNDDRDDDDDNRB
BRDDDDDDDDDDDDDRB
BREDDDDDDDDDDDERB
BRRRRRRRRRRRRRRRB
BBBBBBBBBBBBBBBBB